R 1000 1500

S ./path_to_the_sprite_texture

F 250,100,12
C 200,210,120

NO ./path_to_the_north_texture
SO ./path_to_the_south_texture
WE ./path_to_the_west_texture
EA ./path_to_the_east_texture

  11111
1110001
1000111
10N01
11111
